AFAR                = "aa"
ABKHAZIAN           = "ab"
AFRIKAANS           = "af"
AKAN                = "ak"
AMHARIC             = "am"
ARAGONESE           = "an"
ARABIC              = "ar"
ASSAMESE            = "as"
AVAR                = "av"
AYMARA              = "ay"
AZERBAIJANI         = "az"
BASHKIR             = "ba"
BELARUSIAN          = "be"
BULGARIAN           = "bg"
BIHARI              = "bh"
BISLAMA             = "bi"
BAMBARA             = "bm"
BENGALI             = "bn"
TIBETAN             = "bo"
BRETON              = "br"
BOSNIAN             = "bs"
CATALAN             = "ca"
CHECHEN             = "ce"
CHAMORRO            = "ch"
CORSICAN            = "co"
CREE                = "cr"
CZECH               = "cs"
OLD_CHURCH_SLAVONIC = "cu"
OLD_BULGARIAN       = "cu"
CHUVASH             = "cv"
WELSH               = "cy"
DANISH              = "da"
GERMAN              = "de"
DIVEHI              = "dv"
DZONGKHA            = "dz"
EWE                 = "ee"
GREEK               = "el"
ENGLISH             = "en"
ESPERANTO           = "eo"
SPANISH             = "es"
ESTONIAN            = "et"
BASQUE              = "eu"
PERSIAN             = "fa"
PEUL                = "ff"
FINNISH             = "fi"
FIJIAN              = "fj"
FAROESE             = "fo"
FRENCH              = "fr"
WEST_FRISIAN        = "fy"
IRISH               = "ga"
SCOTTISH_GAELIC     = "gd"
GALICIAN            = "gl"
GUARANI             = "gn"
GUJARATI            = "gu"
MANX                = "gv"
HAUSA               = "ha"
HEBREW              = "he"
HINDI               = "hi"
HIRI_MOTU           = "ho"
CROATIAN            = "hr"
HAITIAN             = "ht"
HUNGARIAN           = "hu"
ARMENIAN            = "hy"
HERERO              = "hz"
INTERLINGUA         = "ia"
INDONESIAN          = "id"
INTERLINGUE         = "ie"
IGBO                = "ig"
SICHUAN_YI          = "ii"
INUPIAK             = "ik"
IDO                 = "io"
ICELANDIC           = "is"
ITALIAN             = "it"
INUKTITUT           = "iu"
JAPANESE            = "ja"
JAVANESE            = "jv"
GEORGIAN            = "ka"
KONGO               = "kg"
KIKUYU              = "ki"
KUANYAMA            = "kj"
KAZAKH              = "kk"
GREENLANDIC         = "kl"
CAMBODIAN           = "km"
KANNADA             = "kn"
KOREAN              = "ko"
KANURI              = "kr"
KASHMIRI            = "ks"
KURDISH             = "ku"
KOMI                = "kv"
CORNISH             = "kw"
KIRGHIZ             = "ky"
LATIN               = "la"
LUXEMBOURGISH       = "lb"
GANDA               = "lg"
LIMBURGIAN          = "li"
LINGALA             = "ln"
LAOTIAN             = "lo"
LITHUANIAN          = "lt"
LATVIAN             = "lv"
MALAGASY            = "mg"
MARSHALLESE         = "mh"
MAORI               = "mi"
MACEDONIAN          = "mk"
MALAYALAM           = "ml"
MONGOLIAN           = "mn"
MOLDOVAN            = "mo"
MARATHI             = "mr"
MALAY               = "ms"
MALTESE             = "mt"
BURMESE             = "my"
NAURUAN             = "na"
NORTH_NDEBELE       = "nd"
NEPALI              = "ne"
NDONGA              = "ng"
DUTCH               = "nl"
NORWEGIAN_NYNORSK   = "nn"
NORWEGIAN           = "no"
SOUTH_NDEBELE       = "nr"
NAVAJO              = "nv"
CHICHEWA            = "ny"
OCCITAN             = "oc"
OJIBWA              = "oj"
OROMO               = "om"
ORIYA               = "or"
OSSETIAN            = "os"
PUNJABI             = "pa"
PALI                = "pi"
POLISH              = "pl"
PASHTO              = "ps"
PORTUGUESE          = "pt"
QUECHUA             = "qu"
RAETO_ROMANCE       = "rm"
KIRUNDI             = "rn"
ROMANIAN            = "ro"
RUSSIAN             = "ru"
RWANDI              = "rw"
SANSKRIT            = "sa"
SARDINIAN           = "sc"
SINDHI              = "sd"
SANGO               = "sg"
SERBO_CROATIAN      = "sh"
SINHALESE           = "si"
SLOVAK              = "sk"
SLOVENIAN           = "sl"
SAMOAN              = "sm"
SHONA               = "sn"
SOMALIA             = "so"
ALBANIAN            = "sq"
SERBIAN             = "sr"
SWATI               = "ss"
SOUTHERN_SOTHO      = "st"
SUNDANESE           = "su"
SWEDISH             = "sv"
SWAHILI             = "sw"
TAMIL               = "ta"
TELUGU              = "te"
TAJIK               = "tg"
THAI                = "th"
TIGRINYA            = "ti"
TURKMEN             = "tk"
TAGALOG             = "tl"
TSWANA              = "tn"
TONGA               = "to"
TURKISH             = "tr"
TSONGA              = "ts"
TATAR               = "tt"
TWI                 = "tw"
TAHITIAN            = "ty"
UYGHUR              = "ug"
UKRAINIAN           = "uk"
URDU                = "ur"
VENDA               = "ve"
VIETNAMESE          = "vi"
VOLAPÃœK             = "vo"
WALLOON             = "wa"
WOLOF               = "wo"
XHOSA               = "xh"
YIDDISH             = "yi"
YORUBA              = "yo"
ZHUANG              = "za"
CHINESE             = "zh"
ZULU                = "zu"